32 32 32 32 32 32 32 32 32 32 32 32 32 32 32 32 32 32 32 32 32 32 32 32 32 32 32 32 32 32 32 32 32 32 32 32 32 32 32 32 32 32 32 32 32 32 32 32 32 32 
32 57 57 57 57 57 57 32 32 57 57 57 57 57 57 57 57 57 57 57 57 57 57 57 57 57 57 32 57 57 57 57 57 57 57 57 57 32 32 57 57 57 57 57 57 57 57 57 57 32 
32 57 57 57 32 57 57 32 32 57 57 32 57 57 57 32 57 57 57 32 57 57 57 32 57 57 57 32 57 57 57 32 32 32 57 57 57 32 32 57 57 57 57 57 57 57 57 57 57 32 
32 57 32 32 32 57 57 32 32 57 57 32 32 32 32 32 32 32 32 32 32 32 32 32 57 32 57 32 57 57 57 57 57 32 57 57 57 32 32 57 57 57 32 32 32 32 32 57 57 32 
32 57 57 32 32 57 57 57 57 57 57 32 57 57 57 57 32 57 57 57 57 57 57 57 57 32 57 32 57 57 57 57 57 32 57 57 57 32 32 57 57 57 57 57 57 57 32 57 57 32 
32 57 57 32 32 57 32 57 32 57 57 32 57 57 57 57 32 32 32 32 32 32 32 32 32 32 57 32 57 57 57 57 57 32 57 57 57 32 32 57 57 57 57 57 57 57 32 57 57 32 
32 57 32 32 32 32 32 32 32 57 57 32 57 57 57 57 57 57 57 57 57 57 57 57 57 57 57 32 57 57 57 57 57 32 57 57 57 32 32 32 32 32 32 32 57 57 32 57 57 32 
32 57 57 32 32 57 57 32 32 57 57 32 57 57 32 32 32 32 32 32 32 32 32 32 32 32 32 32 32 32 57 57 57 32 57 57 57 32 32 32 32 32 32 32 57 57 32 57 57 32 
32 57 57 32 32 57 57 32 32 57 57 32 57 57 57 57 57 32 57 57 57 57 57 57 57 57 57 57 57 57 57 57 57 32 57 57 57 57 57 57 57 57 57 57 57 57 32 57 57 32 
32 57 57 32 32 57 57 32 32 57 57 32 57 57 32 32 32 32 57 32 57 57 57 57 32 57 57 57 32 57 57 57 57 32 57 57 57 57 57 57 57 57 57 57 57 57 32 57 57 32 
32 57 32 32 32 57 57 32 32 57 57 32 57 57 57 57 57 57 57 32 32 32 32 32 32 32 32 32 32 32 57 57 57 32 32 32 32 32 32 32 32 32 32 32 32 32 32 57 57 32 
32 57 57 32 32 57 57 32 32 57 57 32 57 57 57 57 57 57 57 32 57 57 57 57 57 32 57 57 57 57 57 57 57 57 57 57 32 57 57 32 57 57 57 57 57 57 32 57 57 32 
32 57 57 32 32 57 57 32 32 57 57 32 57 57 32 32 32 32 32 32 57 57 57 57 57 32 32 32 32 32 32 32 32 57 57 57 32 57 57 32 32 32 32 32 32 57 32 57 57 32 
32 57 57 32 57 57 57 57 32 57 57 32 57 57 32 32 32 32 32 32 57 57 57 57 57 57 57 57 57 57 57 57 57 57 57 57 57 57 57 57 57 57 57 57 32 57 32 57 57 32 
32 57 57 57 57 57 57 57 57 57 57 32 57 57 57 57 57 57 57 57 57 57 32 32 32 32 32 32 32 32 32 32 32 32 32 32 32 32 32 32 32 57 57 57 32 57 32 57 57 32 
32 32 32 32 32 32 32 57 57 57 57 32 57 57 57 57 57 57 57 57 57 57 32 57 57 57 57 57 32 57 57 57 32 32 57 57 57 57 57 57 57 57 57 57 57 57 32 57 57 32 
32 57 57 57 57 57 32 57 57 57 57 32 57 57 57 57 57 57 57 57 57 57 32 57 57 57 57 57 32 57 57 57 32 32 57 57 57 57 57 57 57 57 57 57 57 57 32 57 57 32 
32 57 57 32 32 32 32 57 57 57 57 32 57 57 57 57 32 32 32 32 32 32 32 57 57 32 57 57 32 32 57 57 32 32 57 57 57 32 32 32 32 32 32 32 32 32 32 57 57 32 
32 57 57 57 57 57 57 57 57 57 57 32 57 57 57 57 32 32 32 32 32 32 32 57 57 32 57 57 32 32 57 57 32 32 57 57 57 57 57 57 57 57 32 57 57 57 32 57 57 32 
32 57 57 57 57 57 57 57 57 57 57 57 57 57 57 57 57 57 57 57 57 57 57 57 57 32 57 57 32 32 57 57 32 32 57 57 57 32 32 32 32 32 32 57 57 57 32 57 57 32 
32 32 32 32 32 32 32 57 57 57 57 57 57 57 57 57 57 57 57 57 57 57 57 32 32 32 57 57 57 57 57 57 32 32 57 57 57 57 57 57 57 57 57 57 57 57 32 57 57 32 
32 32 32 32 32 32 32 57 57 57 57 32 32 32 57 57 32 32 32 32 32 32 32 32 57 57 57 57 57 57 57 57 32 32 57 57 57 57 57 57 57 57 57 57 57 57 32 57 57 32 
32 57 57 57 57 57 57 57 57 57 57 57 57 32 57 57 57 57 57 57 57 57 57 32 57 57 32 57 57 32 57 57 32 32 32 32 32 32 32 32 32 32 32 32 57 57 32 57 57 32 
32 57 57 57 57 57 57 57 57 57 57 57 57 32 57 57 57 57 57 57 57 57 57 57 57 57 32 57 57 32 57 57 32 32 32 32 32 32 32 32 32 32 32 32 57 57 32 57 57 32 
32 57 57 32 32 32 32 57 57 32 57 57 57 32 32 32 32 32 32 32 32 32 32 32 32 32 32 57 57 32 57 57 57 57 57 57 57 57 57 57 57 57 57 57 57 57 32 57 57 32 
32 57 57 57 57 57 32 57 57 32 57 57 57 57 57 57 57 57 57 57 57 57 57 57 57 57 57 57 57 32 57 57 57 57 57 57 57 57 57 57 57 57 57 57 57 57 32 57 57 32 
32 57 57 57 57 57 32 57 57 32 57 57 57 57 57 57 57 57 32 32 32 32 32 57 57 57 57 57 57 32 32 32 32 32 32 32 32 32 32 32 32 32 32 32 57 57 32 57 57 32 
32 57 57 57 57 57 32 57 57 32 32 32 32 57 57 32 32 32 32 57 57 57 32 32 57 57 32 57 57 57 57 57 57 57 57 57 57 57 57 57 57 57 57 57 57 57 57 57 57 32 
32 32 32 32 57 57 32 57 57 57 57 57 57 57 57 57 57 57 57 57 57 57 57 57 57 57 32 57 57 57 57 57 57 57 57 57 57 57 57 57 57 57 57 57 57 57 57 57 57 32 
32 57 57 57 57 57 32 57 57 57 57 57 57 57 57 57 57 57 57 32 32 32 32 32 57 57 32 32 32 57 57 32 32 32 32 32 32 32 32 32 32 32 32 32 57 57 32 57 57 32 
32 57 57 57 57 57 32 57 57 32 57 57 32 32 32 32 32 57 57 57 57 57 57 32 57 57 57 57 57 57 57 32 32 57 57 57 57 57 57 57 57 57 32 32 57 57 32 57 57 32 
32 57 57 32 32 32 32 57 57 57 57 57 57 57 57 57 57 57 57 57 57 57 57 32 57 57 57 57 57 57 57 32 32 57 32 32 32 32 32 32 32 57 32 32 57 57 32 57 57 32 
32 57 57 57 57 57 32 57 57 32 32 32 57 57 32 32 32 32 32 57 57 57 57 32 57 57 57 57 57 57 57 32 32 57 32 57 57 32 57 57 32 57 32 32 57 57 32 57 57 32 
32 57 57 57 57 57 32 57 57 57 57 57 57 57 57 57 57 57 32 57 57 57 57 57 57 57 57 57 57 57 57 32 32 57 32 57 57 32 57 57 32 57 32 32 57 57 32 57 57 32 
32 57 57 32 57 57 32 57 57 57 57 57 57 57 57 57 57 57 32 57 57 57 57 57 57 57 57 57 57 57 57 32 32 57 32 57 57 32 57 57 32 57 32 32 57 57 32 57 57 32 
32 57 57 32 57 57 32 32 32 32 32 32 32 32 32 32 57 57 32 32 32 32 32 32 32 32 32 32 57 57 57 32 32 57 32 57 57 32 57 57 32 57 32 32 57 57 32 57 57 32 
32 57 57 32 57 57 57 57 57 57 57 57 57 57 57 32 57 57 57 57 57 32 57 57 57 57 57 57 57 57 57 32 32 57 32 57 57 32 57 57 32 57 32 32 57 57 32 57 57 32 
32 57 57 32 57 57 57 57 57 57 57 57 57 57 57 32 57 57 57 57 57 32 57 57 57 57 57 57 57 57 57 32 32 57 32 57 57 32 57 57 32 57 32 32 57 57 32 57 57 32 
32 57 57 32 32 32 32 32 32 32 32 32 32 57 57 32 32 32 32 57 57 32 57 57 32 32 32 32 57 57 57 32 32 57 57 57 57 32 57 57 57 57 32 32 57 57 32 57 57 32 
32 57 57 57 57 57 57 57 57 57 57 57 57 57 57 57 57 57 57 57 57 32 57 57 32 57 57 57 57 57 57 57 57 57 57 57 57 32 57 57 57 57 57 57 57 57 32 57 57 32 
32 57 57 57 57 57 57 57 57 57 57 57 57 57 57 57 57 57 57 57 57 32 57 57 57 57 57 32 57 57 57 57 32 32 32 32 32 32 32 32 32 32 32 32 32 32 32 57 57 32 
32 32 32 32 32 32 32 32 32 32 57 57 32 32 32 32 32 32 32 57 57 32 57 57 57 57 57 32 57 57 57 57 57 57 57 57 57 57 57 57 57 57 57 57 57 57 32 57 57 32 
32 57 57 57 57 57 57 57 57 57 57 57 32 57 57 57 57 57 32 57 57 32 32 32 32 57 57 32 57 57 57 57 57 57 57 57 57 57 57 57 57 57 57 57 57 57 32 57 57 32 
32 57 57 57 57 57 57 57 57 57 57 57 32 57 57 32 57 57 57 57 57 57 57 57 32 57 57 32 32 32 32 32 32 32 32 32 32 32 32 32 32 32 32 57 57 57 32 57 57 32 
32 57 57 32 57 57 32 32 32 32 57 57 32 57 57 32 57 57 57 57 57 57 57 57 32 57 57 32 57 57 57 57 57 57 57 57 57 57 57 57 57 57 57 57 57 57 32 57 57 32 
32 57 57 32 57 57 57 57 57 57 57 57 32 57 57 32 32 32 32 57 57 32 57 57 57 57 57 32 57 57 57 57 57 57 57 57 57 57 57 57 57 57 57 57 57 57 32 57 57 32 
32 57 57 32 57 57 32 57 57 32 57 57 32 57 57 57 57 57 32 57 57 32 57 57 57 57 57 32 32 32 57 57 32 32 32 32 32 32 32 32 32 32 32 32 32 32 32 57 57 32 
32 57 57 32 57 57 32 57 57 32 57 57 32 32 32 32 57 57 32 57 57 32 32 32 57 57 57 32 57 57 57 57 32 57 57 57 57 57 57 32 57 57 57 57 57 57 32 57 57 32 
32 37 57 57 57 57 32 57 57 57 57 57 57 57 57 57 57 57 32 57 57 57 57 57 57 57 57 32 57 57 57 57 57 57 57 57 57 57 57 57 57 57 57 57 57 57 57 57 37 32 
32 32 32 32 32 32 32 32 32 32 32 32 32 32 32 32 32 32 32 32 32 32 32 32 32 32 32 32 32 32 32 32 32 32 32 32 32 32 32 32 32 32 32 32 32 32 32 32 32 32 
